XXXXXXXXXXXXXXXXX
X    OOOOOOOOO  X
X W W W WOW W W X
XOOO     O   OOOX
XOWOW W WOW WOWOX
XOOO     O     OX
X W W W WOW WOWOX
X        O   OOOX
X W W W WOW W WOX
X        O      X
X W W W WOW W W X
X      OOOO     X
XXXXXXXXXXXXXXXXX