XXXXXXXXXXXXXXXXXX
X O  OO O   OO OOX
X X XOXOX XOXOX  X
XO  OOOOO OOOO  OX
X XOXOX XOXOXOX  X
XO   OOOOO   O  OX
X XOX XOXOXOXOX  X
XOOO  OOOOO   O OX
X XOXOXOX XOXOXO X
X    O O  OOOO OOX
X X XOXOXOXOX XO X
XOOO  O  OOOOOO OX
X XOX X XOX XOXO X
X O OOOOOO O O  OX
X X XOXOX XOX XO X
X OOO O OO  O  OOX
XXXXXXXXXXXXXXXXXX
