XXXXXXXXXXXXXXXXX
X  O O    O OO  X
X XOXOX XOX X X X
XOO OOO    OO  OX
X X XOX XOXOXOXOX
XO O OO OOO OO OX
X XOX X X XOX XOX
X OO  O     O  OX
X XOXOX XOXOXOXOX
XOO OOO    O  OOX
X XOX X X XOXOXOX
X O OO  OO OOOOOX
X X X XOXOXOX XOX
XOO  OOO OOOOOOOX
X X X XOX XOXOX X
X  O OO OOO OO  X
XXXXXXXXXXXXXXXXX
