XXXXXXXXXXXXXXXXXX
X OO    O     O  X
X XOXOXOXOX X XO X
XOO O O O  O   OOX
X X XOXOXOX XOX  X
XOOO O OO   OOO OX
X X X XOXOXOX X  X
X O   O O  OOOOOOX
X X X XOX X XOX  X
X  O OO    OOOO OX
X X XOX X XOX XO X
X    O   OO OO  OX
X XOXOX XOX XOX  X
XO O  O   OOOO  OX
X XOXOX XOXOX X  X
X    OO  O  OOO  X
XXXXXXXXXXXXXXXXXX
