XXXXXXXXXXXXXXXXX
X  OOO  O O  O  X
X X XOXOXOXOX X X
XOO OO  OO  O  OX
X XOXOX X X XOXOX
XO OO O  OOO  OOX
X X XOX X X XOXOX
X O OO   O  O  OX
X X XOXOX XOXOXOX
XOO    OOOOOO OOX
X X X X X XOXOXOX
X   OOO  O OOO OX
X X XOXOX XOXOXOX
XOOO   OO OOOOOOX
X XOX X XOX X X X
X  OO  OO OO O  X
XXXXXXXXXXXXXXXXX
