XXXXXXXXXXXXXXXXXX
X O OO   O O O O X
X X XOXOXOXOX XO X
XO  OO O O OO O OX
X XOXOXOX X X XO X
X OOO O  O OO   OX
X XOXOX XOX X XO X
X  O   O  O    OOX
X XOX XOXOX XOX  X
XOO  OO O O O OOOX
X X X X XOXOX X  X
X  O       O O OOX
X XOXOX X XOXOX  X
XO OOO   OO     OX
X XOXOX X XOXOX  X
X OOO OO OO OOO  X
XXXXXXXXXXXXXXXXXX
