XXXXXXXXXXXXXXXXX
X  O  O OO O O  X
X X XOXOXOXOXOX X
XO   O OOO OOO OX
X XOX X XOXOX XOX
XO O O    OOO  OX
X X X X X X X XOX
X  O   O  O OO OX
X X XOXOXOXOXOXOX
X O   OOO  OOO OX
X X X X X X XOXOX
X O O OOOOO O OOX
X XOX XOX XOXOXOX
XOO  OOO O OOO OX
X XOX X X XOXOX X
X  O  O  O   O  X
XXXXXXXXXXXXXXXXX
