XXXXXXXXXXXXXXXXXX
X    O  O  OO    X
X XOX X XOX X X  X
X   O O O O  OOOOX
X X X XOX XOXOXO X
X OOO   OOO   OOOX
X X XOXOXOXOXOXO X
X O   O O OO    OX
X XOX XOX X XOX  X
XOO  O   O OO O OX
X X X X X XOXOXO X
X O O OOO O O   OX
X X X XOX XOX X  X
X OOO  O O  OO  OX
X XOX XOXOXOX XO X
X    O O OOOOO O X
XXXXXXXXXXXXXXXXXX
