XXXXXXXXXXXXXX
X OOO O OO OXX
X XOXOXOXOXOXX
X  O   OO   XX
X XOXOXOXOXOXX
XOOO O O OOOXX
X X XOXOXOXOXX
X      OOOOOXX
X X XOXOX X XX
XO OOO  OOOOXX
X XOXOX XOXOXX
XOO OOOOOOOOXX
X XOXOXOXOXOXX
X O OO OO O XX
X XOX XOXOXOXX
XO OO OO OO XX
XXXXXXXXXXXXXX
