XXXXXXXXXXXXXXXXXX
X O O  O OOOO OOOX
X XOXOXOX XOXOX  X
X OOOOO    OO OOOX
X XOXOX X X XOXO X
X OOO OOOOO  O OOX
X XOXOXOXOXOXOX  X
XOO  OOOO  O OO OX
X X X X XOXOX X  X
XO  OOOO OOOOOO OX
X XOXOX XOXOXOXO X
XO  O OO OOOO OOOX
X XOXOX XOX XOX  X
XOOO  OO O OOO OOX
X X XOX XOX XOXO X
XOOOOO OO O O  OOX
XXXXXXXXXXXXXXXXXX
