XXXXXXXXXXXXXXXXX
X  OO OOO O  O  X
X XOX XOX X XOX X
XO OOO OO O   OOX
X XOXOX X XOXOXOX
X OOOOOOO OOOOOOX
X X XOX XOXOXOXOX
XOOO OOO O OO OOX
X X XOX X XOX XOX
X  OOOO      OOOX
X XOXOXOX X X XOX
X   OOO  O     OX
X X XOX XOX XOXOX
XO OOOO  OOO   OX
X X XOX XOX XOX X
X  O O OOOOOOO  X
XXXXXXXXXXXXXXXXX
