XXXXXXXXXXXXXXXXXX
X O   OOOO   O   X
X XOX X XOXOXOXO X
XO O O  OOOO  O OX
X X X XOXOX X XO X
X O  O  O OOO   OX
X XOX X X X XOX  X
XO O   O OOO O OOX
X XOX XOXOXOXOXO X
X O   O O OOO  OOX
X XOX X X X X XO X
XO  OO OOOO  OOOOX
X X XOX X XOXOX  X
X OOOOO OO  O O OX
X XOX XOXOX XOXO X
X    O  OOOOOOOO X
XXXXXXXXXXXXXXXXXX
