XXXXXXXXXXXXXXXXX
X  OOOOO OOO O  X
X X X X XOXOXOX X
XOOO   O O   O OX
X XOX X XOX X XOX
XO  OOO O OO O OX
X X X X X X XOXOX
X      OOOOO  OOX
X X X X XOX X XOX
XOO O OO  OOOO OX
X X X XOX X XOXOX
X OOOO OO  O O OX
X X X X XOX X XOX
XO O OO O   O  OX
X XOX XOX X X X X
X  O O O OOOOO  X
XXXXXXXXXXXXXXXXX
