XXXXXXXXXXXXXX
XOO OOOO  OOXX
X XOXOXOXOX XX
XOOOOO  OOOOXX
X XOX X XOXOXX
XOOO OO  O OXX
X XOX XOX XOXX
XO   OO  O OXX
X X XOXOX X XX
X   OOOOOOO XX
X XOX XOX X XX
X  OOO OOO  XX
X XOXOXOXOXOXX
XOOO O OO O XX
X XOXOXOXOX XX
X OOOOOO O OXX
XXXXXXXXXXXXXX
