XXXXXXXXXXXXXXXXX
X  O O O  OO O  X
X X X XOX XOXOX X
XOOO    O O   OOX
X XOX XOXOX XOXOX
X     O OOOOOOOOX
X X X X XOX XOXOX
X O OOOOO OOO  OX
X X X X X X XOXOX
XO O O  OO  OO OX
X XOX X X X X XOX
XOOO    OO O  OOX
X XOX X XOXOXOXOX
XO  O O   O   OOX
X XOX X X XOX X X
X  OO O   O OO  X
XXXXXXXXXXXXXXXXX
