XXXXXXXXXXXXXX
X  OOOOOOOO XX
X XOX XOXOXOXX
X OOOO O  O XX
X XOXOXOX XOXX
XO OOOO OO OXX
X XOXOXOXOX XX
X OOOOOO O  XX
X X X X XOXOXX
XOO   OO  OOXX
X XOXOXOX XOXX
XOO OOO  OOOXX
X XOX XOXOX XX
XOO O O OO  XX
X XOXOXOXOXOXX
XOOOO O  OO XX
XXXXXXXXXXXXXX
