XXXXXXXXXXXXXX
X OOOOO OO OXX
X X XOXOXOXOXX
X OOOOO   OOXX
X XOXOXOX XOXX
X  OO OO  O XX
X XOX X XOX XX
X OO O O O  XX
X XOXOXOX XOXX
XOOO OO    OXX
X XOXOXOX XOXX
XOOO OOOO OOXX
X XOXOXOXOX XX
X OOOOOOO  OXX
X X XOXOX X XX
XOO  OO OO OXX
XXXXXXXXXXXXXX
