XXXXXXXXXXXXXXXXX
X  OOO O OO  O  X
X XOX XOXOX XOX X
XOO O O   OOOO OX
X X X XOX X X XOX
XOOO     O OOOOOX
X X XOX XOXOX XOX
XOOO    O  O   OX
X X XOX X X XOXOX
XOOOO O   O    OX
X XOXOX X X XOXOX
X    OO        OX
X XOXOX X X X XOX
XOOO OO OO   OOOX
X XOX XOXOXOXOX X
X  OOOO   O  O  X
XXXXXXXXXXXXXXXXX
