XXXXXXXXXXXXXXXXXX
X  O OO  OOOOOOO X
X X X X X XOX X  X
X O  O    O OO OOX
X X XOX XOX XOXO X
X    OOO  OO OOOOX
X X XOXOXOXOX XO X
X  O      OOOOOOOX
X XOXOX X X X X  X
XO     O O   O OOX
X XOXOXOXOXOXOXO X
X OO   OOO   OO OX
X X X X XOX XOX  X
X O  OO O OOO O OX
X XOXOX X X XOXO X
X       OO O  OO X
XXXXXXXXXXXXXXXXXX
