XXXXXXXXXXXXXXXXXX
XO O O OOOOOO O OX
X X XOXOXOXOX X  X
XOOO O  OO  O OOOX
X XOX XOXOXOXOX  X
XO   OOO OOOO O OX
X XOXOXOX XOXOX  X
X  OOOOOOOOOO OOOX
X XOXOXOXOXOX XO X
X  OOOOOO OOOOOOOX
X XOXOXOX X XOXO X
XOOOOOOOO  O OO OX
X XOX X X XOXOXO X
XOOOO OO O   OOOOX
X X X XOXOX XOX  X
X OO O O OOOO  OOX
XXXXXXXXXXXXXXXXXX
