XXXXXXXXXXXXXX
XOOO OOOOOOOXX
X XOXOXOX XOXX
XOO  OO O  OXX
X XOX X XOXOXX
X     OOOO  XX
X XOXOX XOX XX
XO  O  OOOOOXX
X X X X XOXOXX
X    OOOOOO XX
X X XOX XOXOXX
X   O OOO O XX
X XOXOXOXOXOXX
X O   O OOO XX
X XOX X XOXOXX
XOOOOO OOOOOXX
XXXXXXXXXXXXXX
