XXXXXXXXXXXXXX
X OO    OO  XX
X XOXOXOX X XX
XOO OOO OO  XX
X XOX XOXOXOXX
X    O OO OOXX
X XOX X X X XX
XO OOO   O OXX
X X XOXOXOX XX
X  OO  OOO  XX
X XOXOXOX XOXX
XO O OOOOOO XX
X XOXOXOXOXOXX
XOO OO OOOO XX
X XOX XOX XOXX
XO    OOO OOXX
XXXXXXXXXXXXXX
