XXXXXXXXXXXXXXXXX
X  OO OO OO OO  X
X XOX XOXOX X X X
XOOO OO  O OO  OX
X X X X X X XOXOX
X OOOO OO     OOX
X X XOX XOX X XOX
XOOOO   OO  O  OX
X X XOXOXOX XOXOX
X  OOOO OO  O  OX
X X XOXOX X XOXOX
XO  OO  O   O  OX
X XOX X XOXOXOXOX
XO  OO  OO O OOOX
X XOX X X XOXOX X
X  O O OO OOOO  X
XXXXXXXXXXXXXXXXX
