XXXXXXXXXXXXXXXXX
X  O     O O O  X
X X X X XOX X X X
XOO  O OOOOO  OOX
X XOX XOXOX X XOX
X OO     OOOO  OX
X XOX X XOX X XOX
X   O   OOO OO OX
X X XOX XOXOX XOX
XO    OO O O   OX
X XOXOXOXOXOXOXOX
XOO O  O   OOO OX
X X X XOX XOXOXOX
XO  O      O OOOX
X X XOXOXOXOXOX X
X  O  O O  OOO  X
XXXXXXXXXXXXXXXXX
