XXXXXXXXXXXXXXXXX
X  O O     O O  X
X X XOXOX XOX X X
XOO  O  OO OOOOOX
X X X X XOXOXOXOX
X  O OO O  O O OX
X X X XOX XOXOXOX
X OO    O   O  OX
X X XOX XOX X XOX
XO OOO OO O    OX
X XOXOX XOX XOXOX
XOO   OOO  O OOOX
X X XOX X XOX XOX
XO O OOOO  O OOOX
X XOXOXOXOXOXOX X
X  OO OOO   OO  X
XXXXXXXXXXXXXXXXX
