XXXXXXXXXXXXXXX
X   oooooooo  X
X XoX X X X X X
X oo oooo ooooX
XoX XoXoXoXoXoX
Xoooooo oo   oX
XoXoXoXoXoXoX X
Xo o o ooo  ooX
XoXoXoX XoXoXoX
X ooooooooooooX
X XoX X X XoX X
X  ooooo ooo  X
XXXXXXXXXXXXXXX